SO             ./path_to_the_south_texture


          NO ./path_to_the_north_texture

WE ./path_to_the_west_texture

EA             ./path_to_the_east_texture




               F   120,     44   ,   1    


        C            215,     30     ,   0


111111111111111111111111
100000000000000000000001
100000000000000000000001
100000000000000000000001
100000111110000101010001
100000100010000000000001
100000100010000100010001
100000100010000000000001
100000110110000101010001
100000000000000000000001
100000000000000000000001
100000000000000000000001
100000000000000000111111
100000000000000000111111
100000000000000000111111
100000000000000000000011
111111111000000000111111
110100001000000000000011
110000101000000000000001
11010000100000000N000001
110111111000000000000001
110000000000000000000001
111111111000000000000001
111111111111111111111111