SO             ./path_to_the_south_texture


          NO ./path_to_the_north_texture

WE ./path_to_the_west_texture

EA             ./path_to_the_east_texture




               F   120,     44   ,   1    


        C            215,     30     ,   0


        1111111111111111111111111
        1000000000110000000010001
        1011000001110000000101001
        1001000000000000000010001
111111111011000001110000000000001
100000000011000001110111111111111
1111011111111101110000001000101
11110111111111011101010000001111
110000001101010111000000100011101
100000000000000011000000100011111
10000000000000001101010010001
11000001110101011111011100N0111
11110111 111010101 1111010001
11111111 111111111 1111111111
                        
 
 
 
 
 
 
 111111
 100001
 111111